AAA	G:gain
AAC	G:gain
AAG	C:loss;G:neutral;T:loss
AAT	G:gain
ACA	G:gain
ACC	G:gain
ACG	A:gain;G:gain
ACT	G:gain
AGA	A:loss;C:loss;T:loss	
AGC	A:loss;C:loss;T:loss
AGG	A:neutral;C:loss;T:loss
AGT	A:loss;C:loss;T:loss
ATA	G:gain
ATC	G:gain
ATG	A:gain;G:gain
ATT	G:gain
CAG	C:loss;G:loss;T:loss
CCG	A:gain
CGG	A:gain
CTG	A:gain
GAG	C:loss;G:loss;T:loss
GCG	A:gain
GGG	A:gain
GTG	A:gain
TAG	C:loss;G:loss;T:loss
TCG	A:gain
TGG	A:gain
TTG	A:gain
